111111111111
10C1000000E1
1000011111C1
1P0011000001

111111111111